1111111111111111111111111111111111
1C0001000010000C00000C0000000C01C1
1010010000000000101001011111110101
1P10000010000110001001010000010101
1E00000C1C000C100000000000000000C1
1111111111111111111111111111111111