1111111111111111
1000000000C100E1
1000011110010001
1P0001C0000001C1
1111111111111111