1111111111111111
1C00000000C00001
1000011110000001
1PE011C0000000C1
1111111111111111