11111111111111111111111111
1C00000000C0000000100000C1
11000111100000000010001001
10000000000001C01110000001
100011C0000001000000000001
10000001110000000000000101
10000110000001001000111101
1P0001E00010010C100000C1C1
11111111111111111111111111