1111111111111
101C000C000C1
1011011111011
1P0001E0000C1
1111111111111