111111
1E00C1
101001
101001
1P0001
111111